-########-#########-
#--.....#-#........#
#-#.#.#.#-#.##.###.#
#.#...#.#-#.##.....#
#.#.#.#.#-#....###.#
#.#.#.#.######.#-#.#
#.........#--#.#-#.#
-##.##.##.####.###.#
-##.##.............#
#.....########.###.#
#.###.#----#.......#
#.#-#.#----#.#####.#
#.###.######.#####.#
#..................#
-##################-